P q . s s . . M
Q p . s s . . .
# # # . . # # #
# # # . . # # #
s s # s s # s s
s s # s s # s s
. . . s s . . .
# . # s s # . #
