s s . s . . P .
s # . . . . . Q
. . M s s # . .
s . s # s s . .
. . s s # s . s
. . # s s . . .
q . . . . . # s
. p . . s . s s
