s . . p s s s M
. s . # . s s s
. . . s . # s s
Q . . . s . . s
. . s s . s # q
. s # s . . . .
s # s . . . s .
s s . P . . . s
