s s # s s s p s
s s # . s Q # q
s s . . . s P s
# . s # # . s s
s . s s # . . s
s . s s s . # #
s s . . . s s s
M s s s # s s s
