p s # . . . # #
s s # . . s P #
# # # s s s s .
. . s s # s . .
. s s M s s . .
. s # s s # # #
s s s s . # s s
Q s . . . # s q
