# . . P Q . . #
. # . . . . # .
. . # s s # . .
. . s # # s . p
q . s # # s . .
. . # s s # . .
. # s s s s # .
# s s s M s s #
