M s # s # s # #
s s s s s s s #
# s s s s s s s
# s s p q s s #
s s s Q P s s s
# s s s s s s #
s s s s s s s s
# # s # s # s s
